WWWWW___WWWWWWW__
WSFFWWWWWAFFFFW__
WWWFWUFFWFWWWFWW_
_WFFFFWFWLFFFFFWW
WWFWVFWFWWWWFFFFW
WFFFFFFFWWWWWFFFW
WFDWFFWFWWFFRWWFW
WFWWFWWFWWFFFFWFW
WFFFFWLFFFWFGFWFW
WWWWWWFWWFWFFFFFW
WFFUFFFWFFFFWWWWW
WFWFFFFFFFWWW____
WFFGFWFFFWW______
WFWFFWWWWW_______
WLFFFW___________
WWFFWW___________
_WWWW____________
