WWWWWWWWWWWWWW_
WSFFFWAFWFFFRWW
WFWWFWWFWFWFFFW
WFFFFFFFFFFFWFW
WWWWFWWFDFWFWFW
_WFFFFWFWWWFFFW
WWFWWFWFFUWFFWW
WFFWFFFFFFFFFWW
WFFUFFFFWFFFFFW
WWWFWFWWWWFFFFW
__WFFFW__WWWWWW
__WWWWW________
